########
#P     #
# ###  #
# #    #
# #    #
#      #
########
