###########
#P    #   #
# ### # ###
# #   #   #
# #  #### #
#         #
###########

