##################
#    P#      #   #
# ### # ## # # # #
# #   #       #  #
# #  #### ###   ##
#           #    #
##################
