##################
#    P#      #   #
# ### # ## # # # #
# #   #       #  #
# #  #### ###   ##
#           #    #
####      # #    #
#      #  # #    #
#  #   #    #    #
#      #    ##   #
#  #   ###       #
#           #    #
#  # #      #    #
#    #      #    #
#    #      #### #
#           #    #
##################
